*********************************************************************************************************
*   *                       *                   *                                               *       *
*   *   ****** ***** ****   *   **** ****   *   *********   **** ******* ******** ******* ***   ** **** *
*   *       *   *           *   *           *               *       *                   *   *   *   *   *
*   *****   *   *   **** **** * *   ***** *** ****** ********   *****   *********   *   *   *   *   *   *
*           *   *               *   *           *       *               *           *       *   *   *   *
***** ***  *** ***** ***   *    *   ****    *   *   *****   **** ****   *************   *   ** **       *
*               *               *           *       *       *       *       *       *       *       *   *
*   ****** *****   ****** ****** ***********   *********   **** ****   *****   *****   *********    *   *
*                   *       *               *               *           *       *       *           *   *
*   ***** ***** *****   *   *   *   *****   *   **** **** ***   *********   *****   *****   *********   *
*               *       *   *   *   *       *   *       *                                           *   *
* **** **** *   *****   *   *   *   *   *****   *   *****   *   *********   *   ** ******   *   *   *   *
*   *       *           *   *   *   *           *   *       *   *       *       *   *       *   *       *
*   *   *   *********** *   ** **   ***** *******   *   *****   *   *   *   *****   *   ** **   *****   *
*       *               *       *   *                   *   *       *   *           *   *       *   *   *
*   * ****** ****   ** ******   *   *   *** **** *** ****   ** *** **   *********   *   *   *****   *   *
*   *           *   *       *   *   *                   *       *       *       *   *   *       *   *   *
*   *   *****   *   *   *   *   *   ****** **** *****   *****   *   *****   *   *****   *****   *   *   *
*       *       *       *           *                           *           *                   *       *
*********************************************************************************************************
